{
  "author": "Pete Cooke", 
  "behaviour": {
    "cameras": true, 
    "destroysfloor": true, 
    "timebombspeed": 1
  }, 
  "conditions": {
    "klondikes": 1, 
    "robots": 0, 
    "timelimit": 0
  }, 
  "elements": {
    "0": {
      "0": ["---;---", "---;---", "---;---", "FLR;FZS", "FLR;---", "---;---", "---;---", "---;---"], 
      "1": ["---;---", "BOX;---", "---;---", "---;---", "---;---", "---;---", "BOX;---", "---;---"], 
      "2": ["---;---", "---;---", "FLR;---", "---;---", "---;---", "FLR;---", "---;---", "---;---"], 
      "3": ["FLR;FZE", "---;---", "---;---", "LFU;---", "FLR;---", "FLR;---", "---;---", "FLR;FZW"], 
      "4": ["FLR;---", "---;---", "---;---", "FLR;---", "BOX;---", "FLR;KLD", "---;---", "FLR;---"], 
      "5": ["---;---", "---;---", "FLR;---", "---;---", "---;---", "FLR;---", "---;---", "---;---"], 
      "6": ["---;---", "BOX;---", "---;---", "---;---", "---;---", "---;---", "BOX;---", "---;---"], 
      "7": ["---;---", "---;---", "---;---", "FLR;FZN", "FLR;---", "---;---", "---;---", "---;---"]
    }, 
    "1": {
      "0": ["---;---", "---;---", "---;---", "---;---", "---;---", "---;---", "---;---", "---;---"], 
      "1": ["---;---", "FLR;---", "---;---", "---;---", "---;---", "---;---", "FLR;---", "---;---"], 
      "2": ["---;---", "---;---", "BOX;---", "---;---", "---;---", "BOX;---", "---;---", "---;---"], 
      "3": ["---;---", "---;---", "---;---", "---;---", "BOX;---", "---;---", "---;---", "---;---"], 
      "4": ["---;---", "---;---", "FLR;FRZ", "LFU;---", "FLR;---", "---;---", "---;---", "---;---"], 
      "5": ["---;---", "---;---", "BOX;---", "---;---", "FLR;FCU", "BOX;---", "---;---", "---;---"], 
      "6": ["---;---", "FLR;---", "---;---", "---;---", "---;---", "---;---", "FLR;---", "---;---"], 
      "7": ["---;---", "---;---", "---;---", "---;---", "---;---", "---;---", "---;---", "---;---"]
    }, 
    "2": {
      "0": ["---;---", "---;---", "---;---", "---;---", "---;---", "---;---", "---;---", "---;---"], 
      "1": ["---;---", "---;---", "---;---", "---;---", "---;---", "---;---", "---;---", "---;---"], 
      "2": ["---;---", "---;---", "FLR;---", "---;---", "---;---", "FLR;---", "---;---", "---;---"], 
      "3": ["---;---", "---;---", "---;---", "BOX;---", "LFU;---", "---;---", "---;---", "---;---"], 
      "4": ["---;---", "---;---", "---;---", "---;---", "FLR;---", "---;---", "---;---", "---;---"], 
      "5": ["---;---", "---;---", "FLR;---", "---;---", "---;---", "FLR;---", "---;---", "---;---"], 
      "6": ["---;---", "---;---", "---;---", "---;---", "---;---", "---;---", "---;---", "---;---"], 
      "7": ["---;---", "---;---", "---;---", "---;---", "---;---", "---;---", "---;---", "---;---"]
    }, 
    "3": {
      "0": ["---;---", "---;---", "---;---", "---;---", "---;---", "---;---", "---;---", "---;---"], 
      "1": ["---;---", "---;---", "---;---", "---;---", "---;---", "---;---", "---;---", "---;---"], 
      "2": ["---;---", "---;---", "---;---", "---;---", "---;---", "---;---", "---;---", "---;---"], 
      "3": ["---;---", "---;---", "---;---", "FLR;ZAP", "---;---", "---;---", "---;---", "---;---"], 
      "4": ["---;---", "---;---", "---;---", "FLR;GRB", "FLR;FCU", "---;---", "---;---", "---;---"], 
      "5": ["---;---", "---;---", "---;---", "---;---", "---;---", "---;---", "---;---", "---;---"], 
      "6": ["---;---", "---;---", "---;---", "---;---", "---;---", "---;---", "---;---", "---;---"], 
      "7": ["---;---", "---;---", "---;---", "---;---", "---;---", "---;---", "---;---", "---;---"]
    }
  }, 
  "fx": {
    "groundcolor1": "0xFF002D00", 
    "groundcolor2": "0xFF006900", 
    "groundheight": 2, 
    "liftcolor": "0xFFFFFFFF", 
    "moons": 1, 
    "pattern": 4, 
    "patterncolor1": "0xFF698787", 
    "patterncolor2": "0xFF874B69", 
    "skycolor1": "0xFFB4E1E1", 
    "skycolor2": "0xFF1E5A78", 
    "stars": 0, 
    "style": 0, 
    "suncolor": "0xFFFFFFFF", 
    "sunsize": 2
  }, 
  "id": "024", 
  "title": "La Tour Eiffel", 
  "version": 1
}