{
  "author": "Chris Newcombe", 
  "behaviour": {
    "cameras": true, 
    "destroysfloor": true, 
    "timebombspeed": 2
  }, 
  "conditions": {
    "klondikes": 0, 
    "robots": 4, 
    "timelimit": 135
  }, 
  "elements": {
    "0": {
      "0": ["BOX;---", "---;---", "---;---", "---;---", "---;---", "---;---", "---;---", "BOX;---"], 
      "1": ["BOX;---", "---;---", "---;---", "---;---", "---;---", "---;---", "---;---", "BOX;---"], 
      "2": ["BOX;---", "---;---", "---;---", "---;---", "---;---", "---;---", "---;---", "BOX;---"], 
      "3": ["FLR;HOP", "FLR;---", "FLR;---", "FLR;---", "FLR;---", "FLR;---", "FLR;---", "FLR;---"], 
      "4": ["---;---", "---;---", "---;---", "---;---", "---;---", "---;---", "---;---", "---;---"], 
      "5": ["---;---", "---;---", "---;---", "FLR;GRB", "FLR;FCD", "---;---", "---;---", "---;---"], 
      "6": ["---;---", "---;---", "---;---", "---;---", "---;---", "---;---", "---;---", "---;---"], 
      "7": ["LFD;---", "FLR;---", "FLR;---", "FLR;---", "FLR;---", "FLR;---", "FLR;ZAP", "BOX;---"]
    }, 
    "1": {
      "0": ["BOX;---", "---;---", "---;---", "---;---", "---;---", "---;---", "---;---", "BOX;---"], 
      "1": ["BOX;---", "---;---", "---;---", "---;---", "---;---", "---;---", "---;---", "BOX;---"], 
      "2": ["FLR;---", "FLR;---", "FLR;---", "FLR;---", "FLR;---", "FLR;---", "FLR;---", "FLR;HOP"], 
      "3": ["---;---", "---;---", "---;---", "---;---", "---;---", "---;---", "---;---", "---;---"], 
      "4": ["---;---", "---;---", "---;---", "---;---", "---;---", "---;---", "---;---", "---;---"], 
      "5": ["---;---", "---;---", "---;---", "---;---", "---;---", "---;---", "---;---", "---;---"], 
      "6": ["---;---", "---;---", "---;---", "---;---", "---;---", "---;---", "---;---", "---;---"], 
      "7": ["---;---", "FLR;---", "FLR;---", "FLR;---", "FLR;---", "FLR;---", "FLR;---", "LFD;---"]
    }, 
    "2": {
      "0": ["BOX;---", "---;---", "---;---", "---;---", "---;---", "---;---", "---;---", "BOX;---"], 
      "1": ["FLR;HOP", "FLR;---", "FLR;---", "FLR;---", "FLR;---", "FLR;---", "FLR;---", "FLR;---"], 
      "2": ["---;---", "---;---", "---;---", "---;---", "---;---", "---;---", "---;---", "---;---"], 
      "3": ["---;---", "---;---", "---;---", "---;---", "---;---", "---;---", "---;---", "---;---"], 
      "4": ["---;---", "---;---", "---;---", "---;---", "---;---", "---;---", "---;---", "---;---"], 
      "5": ["---;---", "---;---", "---;---", "---;---", "---;---", "---;---", "---;---", "---;---"], 
      "6": ["---;---", "---;---", "---;---", "---;---", "---;---", "---;---", "---;---", "---;---"], 
      "7": ["LFD;---", "FLR;---", "FLR;---", "FLR;---", "FLR;---", "FLR;---", "FLR;---", "---;---"]
    }, 
    "3": {
      "0": ["FLR;---", "FLR;---", "FLR;---", "FLR;---", "FLR;---", "FLR;---", "FLR;---", "FLR;---"], 
      "1": ["---;---", "---;---", "---;---", "---;---", "---;---", "---;---", "---;---", "---;---"], 
      "2": ["---;---", "---;---", "---;---", "---;---", "---;---", "---;---", "---;---", "---;---"], 
      "3": ["---;---", "---;---", "---;---", "---;---", "---;---", "---;---", "---;---", "---;---"], 
      "4": ["---;---", "---;---", "---;---", "---;---", "---;---", "---;---", "---;---", "---;---"], 
      "5": ["---;---", "---;---", "---;---", "---;---", "---;---", "---;---", "---;---", "---;---"], 
      "6": ["---;---", "---;---", "---;---", "---;---", "---;---", "---;---", "---;---", "---;---"], 
      "7": ["---;---", "FLR;---", "FLR;---", "FLR;---", "FLR;---", "FLR;---", "FLR;---", "FLR;---"]
    }
  }, 
  "fx": {
    "groundcolor1": "0xFF3C4B2D", 
    "groundcolor2": "0xFF5A694B", 
    "groundheight": 5, 
    "liftcolor": "0xFFFFFFFF", 
    "moons": 1, 
    "pattern": 3, 
    "patterncolor1": "0xFFE1E1C3", 
    "patterncolor2": "0xFFE1C3C3", 
    "skycolor1": "0xFF003C3C", 
    "skycolor2": "0xFF00003C", 
    "stars": 34, 
    "style": 8, 
    "suncolor": "0xFFFFFFFF", 
    "sunsize": 3
  }, 
  "id": "066", 
  "title": "The Shooting Gallery.", 
  "version": 1
}