{
  "author": "Chris Newcombe", 
  "behaviour": {
    "cameras": true, 
    "destroysfloor": true, 
    "timebombspeed": 1
  }, 
  "conditions": {
    "klondikes": 1, 
    "robots": 0, 
    "timelimit": 0
  }, 
  "elements": {
    "0": {
      "0": ["FLR;FCU", "FLR;---", "FLR;---", "FLR;---", "FLR;---", "FLR;---", "FLR;---", "FLR;GRB"], 
      "1": ["FLR;---", "---;---", "---;---", "---;---", "---;---", "---;---", "---;---", "FLR;---"], 
      "2": ["FLR;---", "---;---", "---;---", "---;---", "---;---", "---;---", "---;---", "FLR;---"], 
      "3": ["FLR;---", "---;---", "---;---", "---;---", "---;---", "---;---", "---;---", "FLR;---"], 
      "4": ["FLR;---", "---;---", "---;---", "---;---", "---;---", "---;---", "---;---", "FLR;---"], 
      "5": ["FLR;---", "---;---", "---;---", "---;---", "---;---", "---;---", "---;---", "FLR;---"], 
      "6": ["FLR;---", "LFU;---", "---;---", "---;---", "---;---", "---;---", "---;---", "FLR;---"], 
      "7": ["---;---", "FLR;---", "FLR;---", "FLR;---", "FLR;---", "FLR;---", "FLR;---", "FLR;FCD"]
    }, 
    "1": {
      "0": ["---;---", "---;---", "---;---", "---;---", "---;---", "---;---", "---;---", "---;---"], 
      "1": ["---;---", "FLR;---", "FLR;---", "FLR;---", "FLR;---", "FLR;---", "FLR;PSH", "---;---"], 
      "2": ["---;---", "FLR;---", "---;---", "---;---", "---;---", "---;---", "FLR;---", "---;---"], 
      "3": ["---;---", "FLR;---", "---;---", "---;---", "---;---", "---;---", "FLR;---", "---;---"], 
      "4": ["---;---", "FLR;---", "---;---", "---;---", "---;---", "---;---", "FLR;---", "---;---"], 
      "5": ["---;---", "FLR;---", "---;---", "---;---", "---;---", "LFD;---", "FLR;---", "---;---"], 
      "6": ["FLR;PRM", "---;---", "FLR;---", "FLR;---", "FLR;---", "FLR;---", "---;---", "---;---"], 
      "7": ["---;---", "---;---", "---;---", "---;---", "---;---", "---;---", "---;---", "---;---"]
    }, 
    "2": {
      "0": ["---;---", "---;---", "---;---", "---;---", "---;---", "---;---", "---;---", "---;---"], 
      "1": ["---;---", "---;---", "---;---", "---;---", "---;---", "---;---", "---;---", "---;---"], 
      "2": ["---;---", "---;---", "FLR;---", "FLR;---", "FLR;PRM", "---;---", "---;---", "---;---"], 
      "3": ["---;---", "---;---", "FLR;---", "---;---", "LFU;---", "FLR;---", "---;---", "---;---"], 
      "4": ["---;---", "---;---", "FLR;---", "---;---", "---;---", "FLR;---", "---;---", "---;---"], 
      "5": ["---;---", "FLR;---", "FLR;BLK", "FLR;---", "FLR;---", "---;---", "---;---", "---;---"], 
      "6": ["---;---", "---;---", "FLR;HOP", "---;---", "---;---", "---;---", "---;---", "---;---"], 
      "7": ["---;---", "---;---", "---;---", "---;---", "---;---", "---;---", "---;---", "---;---"]
    }, 
    "3": {
      "0": ["---;---", "---;---", "---;---", "---;---", "---;---", "---;---", "---;---", "---;---"], 
      "1": ["---;---", "---;---", "---;---", "---;---", "---;---", "---;---", "---;---", "---;---"], 
      "2": ["---;---", "---;---", "---;---", "---;---", "---;---", "---;---", "---;---", "---;---"], 
      "3": ["---;---", "---;---", "---;---", "FLR;ZAP", "---;---", "---;---", "---;---", "---;---"], 
      "4": ["---;---", "---;---", "---;---", "FLR;KLD", "FLR;BLK", "---;---", "---;---", "---;---"], 
      "5": ["---;---", "---;---", "---;---", "---;---", "---;---", "---;---", "---;---", "---;---"], 
      "6": ["---;---", "---;---", "---;---", "---;---", "---;---", "---;---", "---;---", "---;---"], 
      "7": ["---;---", "---;---", "---;---", "---;---", "---;---", "---;---", "---;---", "---;---"]
    }
  }, 
  "fx": {
    "groundcolor1": "0xFF4B6900", 
    "groundcolor2": "0xFF698700", 
    "groundheight": 1, 
    "liftcolor": "0xFFFFFFFF", 
    "moons": 0, 
    "pattern": 0, 
    "patterncolor1": "0xFFC3C369", 
    "patterncolor2": "0xFFA56900", 
    "skycolor1": "0xFF2D004B", 
    "skycolor2": "0xFF2D004B", 
    "stars": 34, 
    "style": 8, 
    "suncolor": "0xFFFFFFFF", 
    "sunsize": 3
  }, 
  "id": "070", 
  "title": "The Icing On The Cake...", 
  "version": 1
}