{
  "author": "Pete Cooke", 
  "behaviour": {
    "cameras": true, 
    "destroysfloor": true, 
    "timebombspeed": 1
  }, 
  "conditions": {
    "klondikes": 0, 
    "robots": 1, 
    "timelimit": 0
  }, 
  "elements": {
    "0": {
      "0": ["---;---", "---;---", "FLR;---", "---;---", "FLR;---", "---;---", "FLR;---", "---;---"], 
      "1": ["---;---", "---;---", "FLR;---", "---;---", "FLR;---", "---;---", "FLR;---", "---;---"], 
      "2": ["---;---", "---;---", "FLR;---", "---;---", "FLR;---", "---;---", "FLR;LZN", "---;---"], 
      "3": ["BOX;---", "---;---", "FLR;---", "---;---", "FLR;LZN", "---;---", "FLR;---", "BOX;---"], 
      "4": ["BOX;---", "---;---", "FLR;LZN", "FLR;PSH", "FLR;---", "FLR;GRB", "FLR;---", "BOX;---"], 
      "5": ["BOX;---", "---;---", "FLR;---", "---;---", "FLR;---", "---;---", "FLR;---", "BOX;---"], 
      "6": ["LFD;---", "FLR;---", "FLR;---", "FLR;---", "FLR;---", "FLR;---", "FLR;---", "LFU;---"]
    }, 
    "1": {
      "0": ["---;---", "---;---", "---;---", "---;---", "---;---", "---;---", "---;---", "---;---"], 
      "1": ["---;---", "---;---", "---;---", "---;---", "---;---", "---;---", "---;---", "---;---"], 
      "2": ["---;---", "---;---", "---;---", "---;---", "---;---", "---;---", "---;---", "---;---"], 
      "3": ["BOX;---", "---;---", "---;---", "---;---", "---;---", "---;---", "---;---", "BOX;---"], 
      "4": ["BOX;---", "---;---", "---;---", "---;---", "---;---", "---;---", "---;---", "BOX;---"], 
      "5": ["LFD;---", "---;---", "---;---", "---;---", "---;---", "---;---", "---;---", "LFU;---"], 
      "6": ["---;---", "---;---", "---;---", "---;---", "---;---", "---;---", "---;---", "---;---"]
    }, 
    "2": {
      "0": ["---;---", "---;---", "---;---", "---;---", "---;---", "---;---", "---;---", "---;---"], 
      "1": ["---;---", "---;---", "---;---", "---;---", "---;---", "---;---", "---;---", "---;---"], 
      "2": ["---;---", "---;---", "---;---", "---;---", "---;---", "---;---", "---;---", "---;---"], 
      "3": ["BOX;---", "---;---", "---;---", "---;---", "---;---", "---;---", "---;---", "BOX;---"], 
      "4": ["LFD;---", "---;---", "---;---", "---;---", "---;---", "---;---", "---;---", "LFU;---"], 
      "5": ["---;---", "---;---", "---;---", "---;---", "---;---", "---;---", "---;---", "---;---"], 
      "6": ["---;---", "---;---", "---;---", "---;---", "---;---", "---;---", "---;---", "---;---"]
    }, 
    "3": {
      "0": ["---;---", "---;---", "---;---", "---;---", "---;---", "---;---", "---;---", "---;---"], 
      "1": ["---;---", "---;---", "---;---", "---;---", "---;---", "---;---", "---;---", "---;---"], 
      "2": ["---;---", "---;---", "---;---", "---;---", "---;---", "---;---", "---;---", "FLR;HOP"], 
      "3": ["FLR;ZAP", "---;---", "---;---", "---;---", "---;---", "---;---", "FLR;REL", "FLR;---"], 
      "4": ["---;---", "---;---", "---;---", "---;---", "---;---", "---;---", "---;---", "---;---"], 
      "5": ["---;---", "---;---", "---;---", "---;---", "---;---", "---;---", "---;---", "---;---"], 
      "6": ["---;---", "---;---", "---;---", "---;---", "---;---", "---;---", "---;---", "---;---"]
    }
  }, 
  "fx": {
    "groundcolor1": "0xFF1E0000", 
    "groundcolor2": "0xFF3C1E00", 
    "groundheight": 8, 
    "liftcolor": "0xFFFFFFFF", 
    "moons": 0, 
    "pattern": 0, 
    "patterncolor1": "0xFF96D200", 
    "patterncolor2": "0xFF5AD25A", 
    "skycolor1": "0xFF005A96", 
    "skycolor2": "0xFF005A78", 
    "stars": 0, 
    "style": 0, 
    "suncolor": "0xFFFFFFFF", 
    "sunsize": 4
  }, 
  "id": "087", 
  "title": "The Valley", 
  "version": 1
}