{
  "author": "Chris Newcombe",
  "behaviour": {
    "cameras": true,
    "destroysfloor": true,
    "timebombspeed": 2
  },
  "conditions": {
    "klondikes": 0,
    "robots": 4,
    "timelimit": 135
  },
  "elements": {
    "0": {
      "7": [{"f": "BOX", "o": "---"}, {"f": "---", "o": "---"}, {"f": "---", "o": "---"}, {"f": "---", "o": "---"}, {"f": "---", "o": "---"}, {"f": "---", "o": "---"}, {"f": "---", "o": "---"}, {"f": "BOX", "o": "---"}],
      "6": [{"f": "BOX", "o": "---"}, {"f": "---", "o": "---"}, {"f": "---", "o": "---"}, {"f": "---", "o": "---"}, {"f": "---", "o": "---"}, {"f": "---", "o": "---"}, {"f": "---", "o": "---"}, {"f": "BOX", "o": "---"}],
      "5": [{"f": "BOX", "o": "---"}, {"f": "---", "o": "---"}, {"f": "---", "o": "---"}, {"f": "---", "o": "---"}, {"f": "---", "o": "---"}, {"f": "---", "o": "---"}, {"f": "---", "o": "---"}, {"f": "BOX", "o": "---"}],
      "4": [{"f": "FLR", "o": "HOP"}, {"f": "FLR", "o": "---"}, {"f": "FLR", "o": "---"}, {"f": "FLR", "o": "---"}, {"f": "FLR", "o": "---"}, {"f": "FLR", "o": "---"}, {"f": "FLR", "o": "---"}, {"f": "FLR", "o": "---"}],
      "3": [{"f": "---", "o": "---"}, {"f": "---", "o": "---"}, {"f": "---", "o": "---"}, {"f": "---", "o": "---"}, {"f": "---", "o": "---"}, {"f": "---", "o": "---"}, {"f": "---", "o": "---"}, {"f": "---", "o": "---"}],
      "2": [{"f": "---", "o": "---"}, {"f": "---", "o": "---"}, {"f": "---", "o": "---"}, {"f": "FLR", "o": "GRB"}, {"f": "FLR", "o": "FCD"}, {"f": "---", "o": "---"}, {"f": "---", "o": "---"}, {"f": "---", "o": "---"}],
      "1": [{"f": "---", "o": "---"}, {"f": "---", "o": "---"}, {"f": "---", "o": "---"}, {"f": "---", "o": "---"}, {"f": "---", "o": "---"}, {"f": "---", "o": "---"}, {"f": "---", "o": "---"}, {"f": "---", "o": "---"}],
      "0": [{"f": "LFD", "o": "---"}, {"f": "FLR", "o": "---"}, {"f": "FLR", "o": "---"}, {"f": "FLR", "o": "---"}, {"f": "FLR", "o": "---"}, {"f": "FLR", "o": "---"}, {"f": "FLR", "o": "ZAP"}, {"f": "BOX", "o": "---"}]
    },
    "1": {
      "7": [{"f": "BOX", "o": "---"}, {"f": "---", "o": "---"}, {"f": "---", "o": "---"}, {"f": "---", "o": "---"}, {"f": "---", "o": "---"}, {"f": "---", "o": "---"}, {"f": "---", "o": "---"}, {"f": "BOX", "o": "---"}],
      "6": [{"f": "BOX", "o": "---"}, {"f": "---", "o": "---"}, {"f": "---", "o": "---"}, {"f": "---", "o": "---"}, {"f": "---", "o": "---"}, {"f": "---", "o": "---"}, {"f": "---", "o": "---"}, {"f": "BOX", "o": "---"}],
      "5": [{"f": "FLR", "o": "---"}, {"f": "FLR", "o": "---"}, {"f": "FLR", "o": "---"}, {"f": "FLR", "o": "---"}, {"f": "FLR", "o": "---"}, {"f": "FLR", "o": "---"}, {"f": "FLR", "o": "---"}, {"f": "FLR", "o": "HOP"}],
      "4": [{"f": "---", "o": "---"}, {"f": "---", "o": "---"}, {"f": "---", "o": "---"}, {"f": "---", "o": "---"}, {"f": "---", "o": "---"}, {"f": "---", "o": "---"}, {"f": "---", "o": "---"}, {"f": "---", "o": "---"}],
      "3": [{"f": "---", "o": "---"}, {"f": "---", "o": "---"}, {"f": "---", "o": "---"}, {"f": "---", "o": "---"}, {"f": "---", "o": "---"}, {"f": "---", "o": "---"}, {"f": "---", "o": "---"}, {"f": "---", "o": "---"}],
      "2": [{"f": "---", "o": "---"}, {"f": "---", "o": "---"}, {"f": "---", "o": "---"}, {"f": "---", "o": "---"}, {"f": "---", "o": "---"}, {"f": "---", "o": "---"}, {"f": "---", "o": "---"}, {"f": "---", "o": "---"}],
      "1": [{"f": "---", "o": "---"}, {"f": "---", "o": "---"}, {"f": "---", "o": "---"}, {"f": "---", "o": "---"}, {"f": "---", "o": "---"}, {"f": "---", "o": "---"}, {"f": "---", "o": "---"}, {"f": "---", "o": "---"}],
      "0": [{"f": "---", "o": "---"}, {"f": "FLR", "o": "---"}, {"f": "FLR", "o": "---"}, {"f": "FLR", "o": "---"}, {"f": "FLR", "o": "---"}, {"f": "FLR", "o": "---"}, {"f": "FLR", "o": "---"}, {"f": "LFD", "o": "---"}]
    },
    "2": {
      "7": [{"f": "BOX", "o": "---"}, {"f": "---", "o": "---"}, {"f": "---", "o": "---"}, {"f": "---", "o": "---"}, {"f": "---", "o": "---"}, {"f": "---", "o": "---"}, {"f": "---", "o": "---"}, {"f": "BOX", "o": "---"}],
      "6": [{"f": "FLR", "o": "HOP"}, {"f": "FLR", "o": "---"}, {"f": "FLR", "o": "---"}, {"f": "FLR", "o": "---"}, {"f": "FLR", "o": "---"}, {"f": "FLR", "o": "---"}, {"f": "FLR", "o": "---"}, {"f": "FLR", "o": "---"}],
      "5": [{"f": "---", "o": "---"}, {"f": "---", "o": "---"}, {"f": "---", "o": "---"}, {"f": "---", "o": "---"}, {"f": "---", "o": "---"}, {"f": "---", "o": "---"}, {"f": "---", "o": "---"}, {"f": "---", "o": "---"}],
      "4": [{"f": "---", "o": "---"}, {"f": "---", "o": "---"}, {"f": "---", "o": "---"}, {"f": "---", "o": "---"}, {"f": "---", "o": "---"}, {"f": "---", "o": "---"}, {"f": "---", "o": "---"}, {"f": "---", "o": "---"}],
      "3": [{"f": "---", "o": "---"}, {"f": "---", "o": "---"}, {"f": "---", "o": "---"}, {"f": "---", "o": "---"}, {"f": "---", "o": "---"}, {"f": "---", "o": "---"}, {"f": "---", "o": "---"}, {"f": "---", "o": "---"}],
      "2": [{"f": "---", "o": "---"}, {"f": "---", "o": "---"}, {"f": "---", "o": "---"}, {"f": "---", "o": "---"}, {"f": "---", "o": "---"}, {"f": "---", "o": "---"}, {"f": "---", "o": "---"}, {"f": "---", "o": "---"}],
      "1": [{"f": "---", "o": "---"}, {"f": "---", "o": "---"}, {"f": "---", "o": "---"}, {"f": "---", "o": "---"}, {"f": "---", "o": "---"}, {"f": "---", "o": "---"}, {"f": "---", "o": "---"}, {"f": "---", "o": "---"}],
      "0": [{"f": "LFD", "o": "---"}, {"f": "FLR", "o": "---"}, {"f": "FLR", "o": "---"}, {"f": "FLR", "o": "---"}, {"f": "FLR", "o": "---"}, {"f": "FLR", "o": "---"}, {"f": "FLR", "o": "---"}, {"f": "---", "o": "---"}]
    },
    "3": {
      "7": [{"f": "FLR", "o": "---"}, {"f": "FLR", "o": "---"}, {"f": "FLR", "o": "---"}, {"f": "FLR", "o": "---"}, {"f": "FLR", "o": "---"}, {"f": "FLR", "o": "---"}, {"f": "FLR", "o": "---"}, {"f": "FLR", "o": "---"}],
      "6": [{"f": "---", "o": "---"}, {"f": "---", "o": "---"}, {"f": "---", "o": "---"}, {"f": "---", "o": "---"}, {"f": "---", "o": "---"}, {"f": "---", "o": "---"}, {"f": "---", "o": "---"}, {"f": "---", "o": "---"}],
      "5": [{"f": "---", "o": "---"}, {"f": "---", "o": "---"}, {"f": "---", "o": "---"}, {"f": "---", "o": "---"}, {"f": "---", "o": "---"}, {"f": "---", "o": "---"}, {"f": "---", "o": "---"}, {"f": "---", "o": "---"}],
      "4": [{"f": "---", "o": "---"}, {"f": "---", "o": "---"}, {"f": "---", "o": "---"}, {"f": "---", "o": "---"}, {"f": "---", "o": "---"}, {"f": "---", "o": "---"}, {"f": "---", "o": "---"}, {"f": "---", "o": "---"}],
      "3": [{"f": "---", "o": "---"}, {"f": "---", "o": "---"}, {"f": "---", "o": "---"}, {"f": "---", "o": "---"}, {"f": "---", "o": "---"}, {"f": "---", "o": "---"}, {"f": "---", "o": "---"}, {"f": "---", "o": "---"}],
      "2": [{"f": "---", "o": "---"}, {"f": "---", "o": "---"}, {"f": "---", "o": "---"}, {"f": "---", "o": "---"}, {"f": "---", "o": "---"}, {"f": "---", "o": "---"}, {"f": "---", "o": "---"}, {"f": "---", "o": "---"}],
      "1": [{"f": "---", "o": "---"}, {"f": "---", "o": "---"}, {"f": "---", "o": "---"}, {"f": "---", "o": "---"}, {"f": "---", "o": "---"}, {"f": "---", "o": "---"}, {"f": "---", "o": "---"}, {"f": "---", "o": "---"}],
      "0": [{"f": "---", "o": "---"}, {"f": "FLR", "o": "---"}, {"f": "FLR", "o": "---"}, {"f": "FLR", "o": "---"}, {"f": "FLR", "o": "---"}, {"f": "FLR", "o": "---"}, {"f": "FLR", "o": "---"}, {"f": "FLR", "o": "---"}]
    }
  },
  "fx": {
    "groundcolor1": "0x3C4B2D",
    "groundcolor2": "0x5A694B",
    "groundheight": 5,
    "liftcolor": "0xFFFFFF",
    "moons": 1,
    "pattern": 3,
    "patterncolor1": "0xE1E1C3",
    "patterncolor2": "0xE1C3C3",
    "skycolor1": "0x003C3C",
    "skycolor2": "0x00003C",
    "stars": 34,
    "style": 8,
    "suncolor": "0xFFFFFF",
    "sunsize": 3
  },
  "id": "066",
  "title": "The Shooting Gallery.",
  "version": 1
}